############
#.#........#
#.#.######.#
#.#....#...#
#.###..#.#.#
#...####.#.#
#.#.#..#.#.#
#.#.#.##.#.#
#o#......#.#
############
